0011111000
0010001100
0010020100
0010205100
0011130100
0000131100
0000130100
0011130100
0010020100
0010200100
0011001100
0001111000
