0000000000
0000000000
0111111110
0100100010
0102332010
0152340110
0102332010
0100100010
0111111110
0000000000
0000000000
0000000000
