000000000000
000000000000
011111000000
010001111110
010203302010
011203322510
001003302010
001111111110
000000000000
000000000000
000000000000
000000000000
