0000000000
0000000000
1111111100
1333333100
1002010110
1020102010
1120202010
0100500010
0111111110
0000000000
0000000000
0000000000
