0111111111
0100010001
0101020001
0102011011
1121311201
1001333001
1003331001
1121131211
1520200001
1000110001
1111111111
0000000000
