0000000000
0000000000
0111111100
0133233100
0133133100
0102220100
0100200100
0102220100
0100150100
0111111100
0000000000
0000000000
