0000000000
0000000000
0111111100
0133330100
1113332111
1002120201
1022001201
1000010001
1111050111
0001111100
0000000000
0000000000
