0000000000
1111111100
1000000100
1012200100
1033310100
1133320110
0101102010
0120020010
0100100510
0111111110
0000000000
0000000000
