0000000000
0000000000
0001111110
0001000010
0111222010
0150233010
0102333110
0111100100
0000111100
0000000000
0000000000
0000000000
