0000000000
0000000000
0011111100
0110000110
0102022010
0133333310
0102202010
0111051110
0001111000
0000000000
0000000000
0000000000
