0000000000
0000000000
0001111100
0111005100
0100230110
0100323010
0111042010
0001000110
0001111100
0000000000
0000000000
0000000000
