0111100000
0100111100
0100200100
0101310100
0101010100
0132323100
0101010100
0101310100
0100220100
0110500100
0010011100
0011110000
