0000011110
0000010010
0000110010
1111132010
1002323010
1523232310
1002323010
1111132010
0000100010
0000110010
0000011110
0000000000
