0000000000
1111111110
1000110010
1010202010
1004310010
1101353110
1121114111
1000000001
1000110101
1111110001
0000011111
0000000000
