0000000000
0000000000
0011111000
1110001111
1000202001
1020002051
1112211111
0010033100
0013333100
0011111100
0000000000
0000000000
