0000000000
0000000000
0111111100
0100320111
0103232001
0142323501
0103232011
0100320010
0111111110
0000000000
0000000000
0000000000
