0000000000
0011111111
0010001301
0110023331
0100201431
1101121011
1000200201
1000100001
1111111501
0000001111
0000000000
0000000000
